........................................
........................................
.....$$$$$####.................@@##.....
.....$$$$$####.................@@##.....
%%%%%%%%%%%%%%%%%%%%%%%%%......@@##.....
%%%%%%%%%%%%%%%%%%%%%%%%%######@@##.....
#####...........######.........@@##.....
........................................
....@@@@@@..@@@@@@@@@@@@@@..@@@@@@@@....
....@..............................@....
....@...%............%.............@....
....@...%...........%%.............@....
.##.@...%..........%.%.............@....
.##.@...%.........%..%.............@....
.##.@...%........%...%.............@....
....@...%............%.............@..#.
....@...%............%.............@..#.
....@...%............%.............@.##.
.##.@...%............%.............@.##.
.##.@...%%%%%%%%%....%.............@....
....@@@@@@@@@@@@@@@...@@@@@@@@@@@@@@....
........................................
........................................
........................................
........................................
........................................
........................................
........................................
........................................
........................................
