........................................
........................................
#%%%%%%%%%%%%%%%%%%%%%%%%%%%%%%%%%%%%%%#
#%%%%%%%%%%%%%%%%%%%%%%%%%%%%%%%%%%%%%%#
#%%%%%%%%%%%%%%%%%%%%%%%%%%%%%%%%%%%%%%#
#%%%%%%%%%%%%%%%%%%%%%%%%%%%%%%%%%%%%%%#
#%%%%%%%%%%%%%%%%%%%%%%%%%%%%%%%%%%%%%%#
#%%%%%%%%%%%%%%%%%%%%%%%%%%%%%%%%%%%%%%#
.##.@...%......%%%%%%%..%%%%%%%%%%%%.##.
.##.@...%............%..%%%%%%%%%%%%.##.
.##.@...%............%..%%%%%%%%%%%%.##.
.##.@...%............%..%%%%%%%%%%%%.##.
.##.@...%............%..%%%%%%%%%%%%.##.
.##.@...%......%%%%%%%..%%%%%%%%%%%%.##.
.##.@...%......%........%%%%%%%%%%%%.##.
.##.@...%......%........%%%%%%%%%%%%.##.
.##.@...%......%........%%%%%%%%%%%%.##.
.##.@...%%%%%%.%%%%%%%..%%%%%%%%%%%%.##.
........................................
...@@..@.@@@@.@@@@.@@@....@@@@..@@@@....
...@.@.@.@@...@@...@..@...@.....@.......
...@..@@.@@@@.@@@@.@@@....@@@@..@@@@....
..........................@..@.....@....
..........................@@@@..@@@@....
...@..@..@@@@..@....@@@@................
...@@@@..@@....@....@@@@................
...@..@..@@@@..@@@..@...................
........................................
........................................
